[[ 0.  0.]
 [ 1. -1.]
 [ 1. -2.]
 [ 2. -2.]
 [ 2. -3.]
 [ 3. -3.]
 [ 3. -4.]
 [ 4. -4.]
 [ 5. -4.]
 [ 5. -4.]
 [ 6. -4.]
 [ 6. -3.]
 [ 7. -3.]
 [ 8. -2.]
 [ 8. -1.]
 [ 9. -1.]]
